File;Temps_cpu_resoldre(cpuTime_sense_temps_cerca);Unitaries_learnt;Binaries_learnt;Binaries_learnt_nova;Binaries_learnt_existent;Unitaries_A_in_binaries_learnt_trobada;Ternaries_learnt;Binaria_AC_trobada;Binaria_AC_amb_retroces_esperat;Binaria_AC_amb_retroces_anterior;Binaria_AB_trobada;Binaries_AC_&_AB_trobades;Unitaria_A_in_ternaria_learnt_trobada;Retroces_per_reduccio_a_binaries_esperat;Retroces_per_reduccio_a_binaries_anterior_al_esperat;Simplificat_a_Binaries(NO CDCL);Simplificat_a_Unitaries(NO CDCL);Quants_cops_fet_cerca_implicacions;Temps_total_segons_fet_cerca_implicacions;Temps_mitjana_segons_fet_cerca_implicacions;Unitaries_descobertes_per_la_cerca_de_implicacions;Unitaries_reedescobertes_en_restart;Unitaries_evitat_restart_afegits;Binaries_AC_recordades_afegides;Binaries_AC_recordades_reedescobertes;Resultat
ENC3_RNDNNGR_15x77_01;1.25591;54;283;283;0;0;313;0;0;0;0;0;0;0;0;2;0;0;0.00000;0.00000;0;0;0;0;0;SAT
ENC3_RNDNNGR_17x77_01;0.81820;7;408;408;0;0;504;2;2;0;4;0;0;6;0;3;0;0;0.00000;0.00000;0;0;0;0;0;SAT
ENC3_RNDNNGR_19x54_01;1.32002;70;265;265;0;0;387;0;0;0;2;0;0;2;0;14;1;0;0.00000;0.00000;0;0;0;0;0;SAT
ENC3_RNDNNGR_19x72_01;23.69216;36;1063;1063;0;0;2489;5;1;4;3;0;0;4;4;6;0;0;0.00000;0.00000;0;0;0;0;0;SAT
ENC3_RNDNNGR_20x56_01;2.96776;30;496;496;0;0;1183;0;0;0;3;0;0;3;0;3;0;0;0.00000;0.00000;0;0;0;0;0;SAT
ENC3_RNDNNGR_22x57_01;1.62553;33;308;308;0;0;641;1;1;0;1;0;0;2;0;3;0;0;0.00000;0.00000;0;0;0;0;0;SAT
ENC3_RNDNNGR_22x63_01;3.14287;20;535;535;0;0;1369;0;0;0;4;0;0;4;0;8;0;0;0.00000;0.00000;0;0;0;0;0;SAT
ENC3_RNDNNGR_25x40_01;0.95501;13;466;466;0;0;810;0;0;0;3;0;0;3;0;2;0;0;0.00000;0.00000;0;0;0;0;0;SAT
ENC3_RNDNNGR_25x66_01;2.23046;49;1042;1042;0;0;1682;1;1;0;3;0;0;4;0;4;0;0;0.00000;0.00000;0;0;0;0;0;SAT
ENC3_RNDNNGR_25x72_01;3.21404;42;363;363;0;0;744;1;0;1;1;0;0;1;1;8;0;0;0.00000;0.00000;0;0;0;0;0;SAT
ENC3_RNDNNGR_25x73_01;1.04619;21;670;670;0;0;834;1;1;0;4;0;0;5;0;1;0;0;0.00000;0.00000;0;0;0;0;0;SAT
ENC3_RNDNNGR_25x76_01;1.51577;34;197;197;0;0;285;0;0;0;3;0;0;3;0;2;0;0;0.00000;0.00000;0;0;0;0;0;SAT
ENC3_RNDNNGR_27x73_01;1.83538;37;907;907;0;0;1131;1;0;1;4;0;0;4;1;2;0;0;0.00000;0.00000;0;0;0;0;0;SAT
ENC3_RNDNNGR_28x56_01;0.88421;30;485;485;0;0;682;1;1;0;4;0;0;5;0;3;0;0;0.00000;0.00000;0;0;0;0;0;SAT
ENC3_RNDNNGR_28x75_01;148.97125;66;2097;2097;0;0;5283;4;3;1;8;0;0;11;1;18;0;0;0.00000;0.00000;0;0;0;0;0;SAT
ENC3_RNDNNGR_28x79_01;9.94842;99;2201;2201;0;0;4032;13;9;4;7;0;0;16;4;9;0;0;0.00000;0.00000;0;0;0;0;0;SAT
ENC3_RNDNNGR_29x38_01;3.25714;21;591;591;0;0;1287;3;1;2;2;0;0;3;2;1;0;0;0.00000;0.00000;0;0;0;0;0;SAT
ENC3_RNDNNGR_29x62_01;9.15758;31;1027;1027;0;0;2293;1;1;0;2;0;0;3;0;4;0;0;0.00000;0.00000;0;0;0;0;0;SAT
ENC3_RNDNNGR_29x68_01;2.66167;49;1412;1412;0;0;1953;5;2;3;12;0;0;14;3;14;0;0;0.00000;0.00000;0;0;0;0;0;SAT
ENC3_RNDNNGR_31x45_01;2.74259;44;373;373;0;0;770;1;1;0;1;0;0;2;0;5;0;0;0.00000;0.00000;0;0;0;0;0;SAT
ENC3_RNDNNGR_31x48_02;1.08852;25;519;519;0;0;893;1;0;1;6;0;0;6;1;4;0;0;0.00000;0.00000;0;0;0;0;0;SAT
ENC3_RNDNNGR_33x64_01;5.03674;84;1625;1625;0;0;2950;5;1;4;13;0;0;14;4;16;0;0;0.00000;0.00000;0;0;0;0;0;SAT
ENC3_RNDNNGR_33x75_02;23.07080;70;2531;2531;0;0;5064;8;4;4;15;0;0;19;4;16;0;0;0.00000;0.00000;0;0;0;0;0;SAT
ENC3_RNDNNGR_33x75_03;7.04598;76;2256;2256;0;0;3557;10;3;7;8;0;0;11;7;26;0;0;0.00000;0.00000;0;0;0;0;0;SAT
ENC3_RNDNNGR_34x54_01;5.22349;83;423;423;0;0;892;2;2;0;1;0;0;3;0;24;0;0;0.00000;0.00000;0;0;0;0;0;SAT
ENC3_RNDNNGR_35x28_01;0.97247;30;361;361;0;0;778;1;1;0;1;0;0;2;0;4;0;0;0.00000;0.00000;0;0;0;0;0;SAT
ENC3_RNDNNGR_35x61_01;3.82323;57;1170;1170;0;0;2247;4;1;3;7;0;0;8;3;8;0;0;0.00000;0.00000;0;0;0;0;0;SAT
ENC3_RNDNNGR_36x76_01;6.52941;98;2793;2793;0;0;3929;9;4;5;17;0;0;21;5;13;0;0;0.00000;0.00000;0;0;0;0;0;SAT
ENC3_RNDNNGR_37x36_01;0.83224;19;392;392;0;0;622;2;0;2;2;0;0;2;2;1;0;0;0.00000;0.00000;0;0;0;0;0;SAT
ENC3_RNDNNGR_37x57_01;1.64883;37;721;721;0;0;1174;0;0;0;4;0;0;4;0;1;0;0;0.00000;0.00000;0;0;0;0;0;SAT
ENC3_RNDNNGR_38x60_01;0.82302;30;297;297;0;0;421;1;1;0;1;0;0;2;0;4;0;0;0.00000;0.00000;0;0;0;0;0;SAT
ENC3_RNDNNGR_38x70_01;2.16080;31;388;388;0;0;571;2;2;0;2;0;0;4;0;7;0;0;0.00000;0.00000;0;0;0;0;0;SAT
ENC3_RNDNNGR_38x76_01;6.63114;147;2921;2921;0;0;4147;10;6;4;14;0;0;20;4;16;0;0;0.00000;0.00000;0;0;0;0;0;SAT
ENC3_RNDNNGR_39x38_01;0.43933;14;309;309;0;0;519;1;0;1;3;0;0;3;1;1;0;0;0.00000;0.00000;0;0;0;0;0;SAT
ENC3_RNDNNGR_40x25_01;1.67454;22;416;416;0;0;647;1;0;1;0;0;0;0;1;4;0;0;0.00000;0.00000;0;0;0;0;0;SAT
ENC3_RNDNNGR_40x50_01;0.93503;23;355;355;0;0;640;0;0;0;2;0;0;2;0;0;0;0;0.00000;0.00000;0;0;0;0;0;SAT
ENC3_RNDNNGR_43x49_01;3.44598;89;1537;1537;0;0;2457;3;0;3;11;0;0;11;3;12;0;0;0.00000;0.00000;0;0;0;0;0;SAT
ENC3_RNDNNGR_43x78_01;14.84898;176;3875;3875;0;0;6167;7;1;6;32;0;0;33;6;25;0;0;0.00000;0.00000;0;0;0;0;0;SAT
ENC3_RNDNNGR_44x45_01;16.62975;55;1375;1375;0;0;2981;4;0;4;8;0;0;8;4;9;0;0;0.00000;0.00000;0;0;0;0;0;SAT
ENC3_RNDNNGR_46x45_01;2.54520;43;873;873;0;0;1427;3;2;1;3;0;0;5;1;5;0;0;0.00000;0.00000;0;0;0;0;0;SAT
ENC3_RNDNNGR_47x69_01;8.50022;118;2544;2544;0;0;4208;14;7;7;17;0;0;24;7;10;0;0;0.00000;0.00000;0;0;0;0;0;SAT
ENC3_RNDNNGR_47x79_01;5.26453;79;1760;1760;0;0;2206;11;3;8;10;0;0;13;8;12;0;0;0.00000;0.00000;0;0;0;0;0;SAT
ENC3_RNDNNGR_48x63_01;21.10956;94;2325;2325;0;0;5261;6;3;3;27;0;0;30;3;10;0;0;0.00000;0.00000;0;0;0;0;0;SAT
ENC3_RNDNNGR_48x67_01;3.45131;60;1440;1440;0;0;1705;3;1;2;9;0;0;10;2;4;0;0;0.00000;0.00000;0;0;0;0;0;SAT
ENC3_RNDNNGR_48x76_01;5.57296;104;2260;2260;0;0;3178;4;3;1;17;0;0;20;1;14;0;0;0.00000;0.00000;0;0;0;0;0;SAT
ENC3_RNDNNGR_49x29_01;6.87397;17;979;977;0;2;2165;1;0;1;7;0;0;7;1;4;0;0;0.00000;0.00000;0;0;2;0;0;SAT
ENC3_RNDNNGR_49x37_01;61.45574;56;1468;1468;0;0;3999;2;1;1;9;0;0;10;1;9;0;0;0.00000;0.00000;0;0;0;0;0;SAT
ENC3_RNDNNGR_49x54_01;7.38432;146;2323;2323;0;0;3763;6;4;2;17;1;0;20;2;14;0;0;0.00000;0.00000;0;0;0;0;0;SAT
ENC3_RNDNNGR_51x38_01;41.94761;111;2607;2607;0;0;5973;7;3;4;15;0;0;18;4;10;0;0;0.00000;0.00000;0;0;0;0;0;SAT
ENC3_RNDNNGR_51x43_01;5.14299;119;1993;1993;0;0;3247;5;1;4;17;0;0;18;4;22;0;0;0.00000;0.00000;0;0;0;0;0;SAT
ENC3_RNDNNGR_51x45_01;11.56216;93;1824;1824;0;0;3728;4;1;3;10;0;0;11;3;16;0;0;0.00000;0.00000;0;0;0;0;0;SAT
ENC3_RNDNNGR_52x34_01;1.32242;20;406;406;0;0;585;0;0;0;1;0;0;1;0;4;0;0;0.00000;0.00000;0;0;0;0;0;SAT
ENC3_RNDNNGR_52x48_01;2.06883;54;808;808;0;0;1226;3;0;3;7;0;0;7;3;5;0;0;0.00000;0.00000;0;0;0;0;0;SAT
ENC3_RNDNNGR_52x56_01;4.53627;90;1702;1702;0;0;2799;2;2;0;5;0;0;7;0;14;0;0;0.00000;0.00000;0;0;0;0;0;SAT
ENC3_RNDNNGR_52x57_01;8.73596;82;658;657;0;1;1463;3;0;3;7;0;0;7;3;36;2;0;0.00000;0.00000;0;1;0;0;0;SAT
ENC3_RNDNNGR_52x61_01;10.61567;88;596;596;0;0;1330;1;1;0;5;0;0;6;0;25;0;0;0.00000;0.00000;0;0;0;0;0;SAT
ENC3_RNDNNGR_53x54_01;10.25338;153;2775;2775;0;0;4761;12;7;5;23;0;0;30;5;17;0;0;0.00000;0.00000;0;0;0;0;0;SAT
ENC3_RNDNNGR_53x74_01;60.96401;389;7324;7324;0;0;13190;32;14;18;73;0;0;87;18;46;0;0;0.00000;0.00000;0;0;0;0;0;SAT
ENC3_RNDNNGR_53x78_01;52.66996;484;9295;9294;0;1;15138;38;18;20;90;0;0;108;20;83;0;0;0.00000;0.00000;0;0;1;0;0;SAT
ENC3_RNDNNGR_54x46_01;3.97932;88;1530;1530;0;0;2476;4;0;4;19;0;0;19;4;5;0;0;0.00000;0.00000;0;0;0;0;0;SAT
ENC3_RNDNNGR_54x77_01;33.30044;370;6923;6923;0;0;10934;30;17;13;71;0;0;88;13;36;0;0;0.00000;0.00000;0;0;0;0;0;SAT
ENC3_RNDNNGR_55x26_01;80.09807;42;1577;1577;0;0;4035;6;3;3;11;0;0;14;3;13;0;0;0.00000;0.00000;0;0;0;0;0;SAT
ENC3_RNDNNGR_55x69_01;7.63062;101;2495;2495;0;0;3447;5;2;3;15;0;0;17;3;18;0;0;0.00000;0.00000;0;0;0;0;0;SAT
ENC3_RNDNNGR_56x22_01;0.63404;11;289;289;0;0;408;0;0;0;3;0;0;3;0;2;0;0;0.00000;0.00000;0;0;0;0;0;SAT
ENC3_RNDNNGR_58x33_01;2.16141;59;1041;1041;0;0;1460;2;1;1;9;0;0;10;1;8;0;0;0.00000;0.00000;0;0;0;0;0;SAT
ENC3_RNDNNGR_58x50_01;10.18293;179;2602;2602;0;0;4569;19;7;12;17;0;0;24;12;20;0;0;0.00000;0.00000;0;0;0;0;0;SAT
ENC3_RNDNNGR_58x66_01;19.56458;289;4825;4825;0;0;7004;12;7;5;43;0;0;50;5;37;0;0;0.00000;0.00000;0;0;0;0;0;SAT
ENC3_RNDNNGR_59x43_01;3.44583;53;1043;1043;0;0;1930;5;3;2;6;0;0;9;2;12;0;0;0.00000;0.00000;0;0;0;0;0;SAT
ENC3_RNDNNGR_59x63_01;345.27502;498;7471;7471;0;0;16367;22;14;8;71;0;0;85;8;30;0;0;0.00000;0.00000;0;0;0;0;0;SAT
ENC3_RNDNNGR_59x72_01;0.75010;16;250;250;0;0;331;0;0;0;0;0;0;0;0;2;0;0;0.00000;0.00000;0;0;0;0;0;SAT
ENC3_RNDNNGR_60x28_01;4.58287;63;481;481;0;0;887;1;0;1;1;0;0;1;1;16;0;0;0.00000;0.00000;0;0;0;0;0;SAT
ENC3_RNDNNGR_60x37_01;4.52123;29;316;316;0;0;604;1;1;0;1;0;0;2;0;8;0;0;0.00000;0.00000;0;0;0;0;0;SAT
ENC3_RNDNNGR_60x67_01;10.73836;186;3871;3871;0;0;5021;6;3;3;26;0;0;29;3;23;0;0;0.00000;0.00000;0;0;0;0;0;SAT
ENC3_RNDNNGR_61x54_01;24.38156;295;4402;4402;0;0;8070;14;4;10;37;0;0;41;10;36;0;0;0.00000;0.00000;0;0;0;0;0;SAT
ENC3_RNDNNGR_61x55_01;2.28946;48;925;925;0;0;1334;2;0;2;4;0;0;4;2;8;0;0;0.00000;0.00000;0;0;0;0;0;SAT
ENC3_RNDNNGR_61x63_01;2.90097;42;900;900;0;0;1240;2;0;2;4;0;0;4;2;6;0;0;0.00000;0.00000;0;0;0;0;0;SAT
ENC3_RNDNNGR_61x70_01;13.99073;221;4666;4665;0;1;6416;20;9;11;38;0;0;47;11;30;0;0;0.00000;0.00000;0;0;1;0;0;SAT
ENC3_RNDNNGR_62x73_01;68.11234;495;10209;10209;0;0;17244;44;24;20;91;0;0;115;20;85;0;0;0.00000;0.00000;0;0;0;0;0;SAT
ENC3_RNDNNGR_62x76_01;50.59201;196;4500;4497;0;3;10188;19;10;9;38;0;0;48;9;23;0;0;0.00000;0.00000;0;0;3;0;0;SAT
ENC3_RNDNNGR_63x55_01;36.81791;213;3724;3723;0;1;7600;11;5;6;23;0;0;28;6;22;0;0;0.00000;0.00000;0;0;1;0;0;SAT
ENC3_RNDNNGR_64x77_01;1.21570;22;403;403;0;0;421;0;0;0;1;0;0;1;0;4;0;0;0.00000;0.00000;0;0;0;0;0;SAT
ENC3_RNDNNGR_65x68_01;17.17863;189;4236;4234;0;2;6390;13;5;8;36;0;0;41;8;34;0;0;0.00000;0.00000;0;0;2;0;0;SAT
ENC3_RNDNNGR_66x47_01;0.56081;22;457;457;0;0;433;2;1;1;5;0;0;6;1;0;0;0;0.00000;0.00000;0;0;0;0;0;SAT
ENC3_RNDNNGR_66x63_01;71.40774;424;7058;7057;0;1;13613;23;5;18;66;0;0;71;18;50;0;0;0.00000;0.00000;0;1;0;0;0;SAT
ENC3_RNDNNGR_66x72_01;20.36666;241;5665;5664;0;1;7634;11;6;5;40;0;0;46;5;33;0;0;0.00000;0.00000;0;0;1;0;0;SAT
ENC3_RNDNNGR_67x57_01;344.65924;169;1346;1345;0;1;3449;5;1;4;5;0;0;6;4;115;1;0;0.00000;0.00000;0;1;0;0;0;IND
ENC3_RNDNNGR_67x61_01;0.90064;17;325;325;0;0;313;0;0;0;0;0;0;0;0;1;0;0;0.00000;0.00000;0;0;0;0;0;SAT
ENC3_RNDNNGR_69x51_01;2.54350;50;997;997;0;0;1323;1;1;0;5;0;0;6;0;8;0;0;0.00000;0.00000;0;0;0;0;0;SAT
ENC3_RNDNNGR_69x68_01;21.82693;221;5066;5065;0;1;7045;16;5;11;48;0;0;53;11;34;0;0;0.00000;0.00000;0;1;0;0;0;SAT
ENC3_RNDNNGR_70x27_01;1.84645;45;997;997;0;0;1240;0;0;0;3;0;0;3;0;4;0;0;0.00000;0.00000;0;0;0;0;0;SAT
ENC3_RNDNNGR_70x54_01;1.16761;21;390;390;0;0;394;1;1;0;1;0;0;2;0;1;0;0;0.00000;0.00000;0;0;0;0;0;SAT
ENC3_RNDNNGR_70x55_01;11.32206;101;658;658;0;0;1183;1;1;0;7;0;0;8;0;37;0;0;0.00000;0.00000;0;0;0;0;0;SAT
ENC3_RNDNNGR_71x60_01;18.91503;217;4365;4364;0;1;6953;13;8;5;40;0;0;48;5;28;0;0;0.00000;0.00000;0;0;1;0;0;SAT
ENC3_RNDNNGR_71x71_01;5.42700;60;1751;1751;0;0;2245;2;1;1;8;0;0;9;1;10;0;0;0.00000;0.00000;0;0;0;0;0;SAT
ENC3_RNDNNGR_72x22_01;0.68495;34;874;874;0;0;1097;2;2;0;9;0;0;11;0;2;0;0;0.00000;0.00000;0;0;0;0;0;SAT
ENC3_RNDNNGR_72x58_01;19.45292;291;5350;5350;0;0;8262;25;12;13;45;0;0;57;13;47;0;0;0.00000;0.00000;0;0;0;0;0;SAT
ENC3_RNDNNGR_73x20_01;1.07451;26;602;602;0;0;942;0;0;0;5;0;0;5;0;2;0;0;0.00000;0.00000;0;0;0;0;0;SAT
ENC3_RNDNNGR_73x32_01;0.99817;33;673;673;0;0;817;2;2;0;2;0;0;4;0;3;0;0;0.00000;0.00000;0;0;0;0;0;SAT
ENC3_RNDNNGR_73x62_01;17.36105;218;4563;4563;0;0;6945;16;8;8;42;0;0;50;8;41;0;0;0.00000;0.00000;0;0;0;0;0;SAT
ENC3_RNDNNGR_74x31_01;10.74112;107;2612;2612;0;0;4324;10;2;8;16;0;0;18;8;14;0;0;0.00000;0.00000;0;0;0;0;0;SAT
ENC3_RNDNNGR_74x35_01;8.93944;124;2719;2719;0;0;4726;8;4;4;25;0;0;29;4;11;0;0;0.00000;0.00000;0;0;0;0;0;SAT
ENC3_RNDNNGR_74x40_01;40.91548;93;739;737;0;2;1738;3;1;2;7;0;0;8;2;139;1;0;0.00000;0.00000;0;1;1;0;0;SAT
ENC3_RNDNNGR_74x54_01;0.64367;10;174;174;0;0;199;0;0;0;3;0;0;3;0;1;0;0;0.00000;0.00000;0;0;0;0;0;SAT
ENC3_RNDNNGR_74x57_01;99.17235;143;1050;1050;0;0;2484;1;0;1;4;0;0;4;1;148;0;0;0.00000;0.00000;0;0;0;0;0;SAT
ENC3_RNDNNGR_74x70_01;56.29374;467;10601;10597;0;4;16026;45;23;22;97;0;0;120;22;77;0;0;0.00000;0.00000;0;1;3;0;0;SAT
ENC3_RNDNNGR_75x70_01;10.34599;107;2981;2980;0;1;3946;7;4;3;18;0;0;22;3;19;0;0;0.00000;0.00000;0;0;1;0;0;SAT
ENC3_RNDNNGR_76x29_01;5.77853;82;740;739;0;1;1104;2;1;1;6;0;0;7;1;16;0;0;0.00000;0.00000;0;0;1;0;0;SAT
ENC3_RNDNNGR_76x34_01;23.71667;140;3204;3203;0;1;5921;14;4;10;17;0;0;21;10;17;0;0;0.00000;0.00000;0;0;1;0;0;SAT
ENC3_RNDNNGR_76x36_01;46.82172;196;4316;4316;0;0;7833;19;8;11;39;0;0;47;11;20;0;0;0.00000;0.00000;0;0;0;0;0;SAT
ENC3_RNDNNGR_76x50_01;4.11706;63;1259;1259;0;0;1687;6;4;2;5;0;0;9;2;6;0;0;0.00000;0.00000;0;0;0;0;0;SAT
ENC3_RNDNNGR_78x24_01;37.39565;88;1152;1152;0;0;2348;5;0;5;9;0;0;9;5;89;0;0;0.00000;0.00000;0;0;0;0;0;SAT
ENC3_RNDNNGR_78x30_01;3.71278;70;1681;1681;0;0;2528;4;1;2;12;1;1;13;2;14;0;0;0.00000;0.00000;0;0;1;0;0;SAT
ENC3_RNDNNGR_78x45_01;11.43352;89;2488;2488;0;0;4852;10;6;4;29;0;0;35;4;11;0;0;0.00000;0.00000;0;0;0;0;0;SAT
ENC3_RNDNNGR_79x35_01;0.62931;18;257;257;0;0;308;1;1;0;0;0;0;1;0;1;0;0;0.00000;0.00000;0;0;0;0;0;SAT
ENC3_RNDNNGR_80x37_01;2.07068;38;1007;1007;0;0;1374;4;1;3;2;0;0;3;3;6;0;0;0.00000;0.00000;0;0;0;0;0;SAT
ENC3_RNDNNGR_80x38_01;27.43525;146;3510;3510;0;0;7226;15;10;5;30;0;0;40;5;21;0;0;0.00000;0.00000;0;0;0;0;0;SAT
ENC3_RNDNNGR_80x50_01;24.68239;337;6612;6612;0;0;10323;21;12;9;79;0;0;91;9;48;0;0;0.00000;0.00000;0;0;0;0;0;SAT
ENC3_RNDNNGR_80x80_01;2.22766;80;240;240;0;0;421;1;1;0;1;0;0;2;0;13;0;0;0.00000;0.00000;0;0;0;0;0;SAT
